5 3 4506 6524 8199 
1 3 2814 212 8296 
3 9 5163 4624 5054 5627 7120 8315 8285 2992 8228 
2 7 8315 8332 7237 8247 6647 8439 5054 
2 6 5163 1502 3636 6873 5741 5827 
1 8 6519 8312 4515 8307 8301 4381 4855 3483 
1 19 339 4998 3560 8055 4345 6793 4465 7144 2667 4219 3210 8480 2355 4600 1891 5150 8432 3139 3176 
1 5 5150 3974 3248 8547 3163 
2 10 5827 8785 8812 5765 4462 6005 3195 6964 8934 3953 
3 4 8228 8143 8167 8103 
2 8 5806 9104 9126 9148 4658 7094 9198 3304 
2 8 3304 9247 9269 5324 9318 7080 9368 3816 
2 11 3309 9526 6230 2970 908 1698 9439 5506 9425 9410 3816 
2 18 3304 9254 9282 9303 5008 7037 9362 4689 9394 9415 2993 6339 9462 9486 9514 6343 5353 9568 
2 3 6343 9554 9526 
2 4 9394 5478 9395 3816 
3 4 9489 4031 9451 1698 
3 13 7855 4251 682 7915 3098 7951 2395 7992 8027 8061 6799 4209 8103 
4 11 5246 6615 5752 9713 9694 3574 5680 1289 4843 9600 5353 
2 10 2877 9768 6403 9715 2729 6508 2494 3284 9595 3309 
4 10 2357 102 3729 10105 10112 10113 10124 3454 10154 2121 
5 12 102 2357 10153 10158 10162 6704 10193 10209 4782 10229 10244 4206 
2 5 2121 10189 3406 5840 10229 
3 14 102 10095 10090 10099 10075 10060 6355 10026 10012 9990 5295 9955 9943 6843 
2 13 10099 1166 10071 10070 10054 6622 10043 4004 6270 9995 9981 3606 9949 
2 9 2877 3393 9810 9827 9849 4737 4540 9903 6843 
2 9 5295 9968 9979 9991 4534 6190 6851 3940 5577 
2 8 5577 5355 574 10029 2555 6198 4189 10003 
3 6 2121 10141 6421 5320 4616 2555 
2 7 2121 6709 10185 6203 2918 10227 2638 
2 14 9949 2675 9902 9886 9871 4357 9828 7106 6535 9791 9778 6417 9709 9694 
2 18 9568 9553 3099 9524 5546 6196 273 6732 9438 9405 4096 3680 877 9311 5529 9253 9231 3071 
2 5 5246 6627 6820 5126 9553 
2 3 5237 9919 2675 
2 9 3953 7262 8771 9014 5784 4696 5380 9067 5806 
2 10 8441 8407 3263 3156 8330 8328 5666 8329 5583 8315 
3 10 7855 7862 4575 7079 7797 7782 5778 7745 3541 7714 
2 2 5936 7745 
2 10 1928 8763 8728 2169 8694 6473 6726 8671 8646 3636 
2 10 1928 4312 3438 3165 8625 8602 1474 3492 8566 8568 
2 18 8568 8577 7170 7103 4156 8456 8423 4519 8364 8348 7108 6807 4120 8275 8248 8212 3862 8109 
2 19 7170 8626 8660 8698 8735 8766 8744 5104 5819 5483 4040 8795 8800 8802 8815 8803 8793 8779 4460 
2 9 8109 8093 8070 8058 8039 8036 470 8018 8002 
2 13 7262 8988 9005 9000 6042 6164 8974 8995 5068 7100 5568 4333 1928 
2 6 8708 8723 10692 8750 8774 8795 
2 10 8574 8605 8628 8652 70 5814 8719 8745 6844 8800 
1 2 8774 6844 
1 2 8750 8745 
1 18 8708 8727 8717 6685 8662 8632 3362 8562 8505 8482 8462 8463 8448 8460 8458 6934 5389 894 
2 14 6799 2874 8079 4950 8095 5636 6933 6434 8092 8087 8069 760 8029 7987 
2 4 5497 7988 5260 7987 
2 16 7987 5426 7932 6857 7891 3079 7837 7810 1046 7772 7752 7743 5495 4632 6691 7745 
2 12 7752 5540 7717 3032 1165 6576 7697 4382 7701 5315 7723 5700 
2 5 1289 9652 5545 9629 3284 
3 5 10003 5306 9967 5630 4967 
2 22 4967 9873 9851 9833 76 1614 9783 1843 9739 4228 1228 9653 1470 4238 9582 2735 2857 4356 4373 9461 7201 4152 
2 2 4152 9489 
2 3 4031 3442 7201 
2 9 9739 3916 9737 5403 5209 9777 2260 2155 9851 
4 10 7727 10133 10698 3114 3955 4117 1917 4028 9265 6504 
2 6 6504 10242 7595 7682 9052 7597 
2 5 7597 5633 585 2381 6872 
5 2 3291 6504 
4 7 7727 10700 9495 6680 1171 6442 5073 
2 8 5073 2743 495 9948 2514 5003 10106 2480 
2 6 2514 594 808 786 4099 2418 
2 8 4325 10103 1443 10118 5004 6338 5114 2480 
5 4 7727 10699 10202 2083 
2 6 4460 8773 5721 8682 1520 8690 
2 11 8690 8737 8770 6616 8775 8786 8804 1305 1319 6888 4253 
2 10 4253 8885 1028 8830 8797 5424 6903 8653 8599 8550 
2 3 8682 5286 5898 
2 15 5898 2564 5681 3677 4078 4247 8008 7994 7971 7957 6948 7953 7968 6191 8002 
2 2 5248 4078 
2 4 5497 5883 8016 8039 
2 6 8441 7175 6136 1562 8589 8625 
2 6 4382 1603 6104 7640 3784 1991 
2 10 7714 7707 7693 2976 5791 7592 4659 7554 512 5768 
2 7 5768 7670 6341 4108 4930 6985 7141 
1 3 5380 6404 6042 
1 2 8114 8628 
5 12 5768 3295 2198 898 7456 5788 7452 2295 138 1808 5142 7526 
5 11 7526 3737 7435 4144 2264 3022 6568 5285 1197 473 5620 
5 11 5620 291 7348 390 2212 1966 2563 1225 1478 1000 7377 
5 10 7377 6416 2775 7413 2852 3247 162 7418 1296 7408 
5 64 7408 98 2988 7349 87 3143 2844 3545 7489 3611 7524 3634 408 7485 2578 7481 518 6631 932 2420 1806 685 2301 1750 144 1262 1456 1802 959 1025 8231 1447 3030 3051 1099 8654 4301 94 282 5414 6630 1418 811 336 57 870 187 1923 1688 356 183 1538 7893 1919 689 6032 4094 1849 4755 6211 2471 6065 1038 581 
3 5 3114 5857 9552 3757 7075 
2 20 2310 10708 10707 124 3267 771 7244 5049 749 3132 10462 6121 753 10357 10334 2018 1377 458 252 4325 
1 10 7870 1810 2785 7768 4852 4196 7739 2532 5386 7763 
2 2 102 10158 
3 4 10162 517 4939 3729 
1 4 2441 8388 2456 8296 
1 14 2884 3472 965 1077 9081 6469 1138 8930 3878 2279 4319 4032 2189 2652 
1 22 5966 2652 2189 4032 8712 6846 8701 219 3147 1485 830 5932 4738 8861 5730 8960 3057 6767 974 6505 3825 1909 
1 13 1909 832 4530 2043 346 3641 7143 2124 223 5408 6368 3083 1077 
1 11 10043 2602 6543 10138 6441 10211 10180 1654 6070 10157 2357 
1 3 6070 2636 10252 
1 2 2814 4506 
1 11 1038 3470 4148 7055 681 2901 4551 7049 2799 6573 6872 
3 2 10256 10244 
1 5 4958 5365 3168 5698 2532 
2 26 3894 1245 5536 4887 3674 9183 3655 6677 1444 6151 962 5222 9171 4962 9182 4787 6236 9290 9313 6757 9360 5618 6556 3222 2442 4152 
1 13 3655 1975 6876 4153 1550 7060 5444 8948 7111 8937 8963 2452 4253 
2 14 9182 3179 9142 9107 733 3914 9039 4137 8997 8962 8920 6663 8743 8795 
2 13 2155 6837 1744 4829 1279 452 1635 1781 1758 4049 2750 552 3894 
1 8 3894 9155 2263 9060 379 4487 4618 2452 
2 16 3894 1662 1431 2399 3791 4726 3701 5970 1863 407 4192 3421 656 1358 534 2822 
1 11 4618 8896 8863 6143 3490 8760 6782 5732 4940 3965 2516 
1 3 8550 5754 3965 
1 3 8653 8665 5732 
1 11 8773 4897 8788 2031 8825 4371 8899 3854 558 8925 5444 
2 11 2822 4198 2428 2311 3081 1587 6592 9224 824 2948 1051 
2 8 1051 9084 5734 9029 1754 3623 3756 3647 
2 19 2155 434 9944 146 1388 5357 1068 4127 5214 511 5131 289 10004 230 1410 9976 9960 5148 2663 
1 6 1388 1659 6252 10030 6185 10003 
2 18 532 2071 920 2725 906 691 1347 1685 5910 5154 2257 2915 10249 3506 2832 3149 10258 2638 
2 6 2725 259 4626 10093 3760 230 
2 11 1410 9935 2614 9813 2288 2390 9640 9584 1856 9466 2389 
2 6 2389 2266 1935 3400 2886 3421 
1 6 1935 2863 6991 3440 9211 2822 
2 16 2389 3425 2139 2306 2156 4568 1457 2949 258 5411 278 2561 9474 9437 163 2000 
2 10 2389 4306 998 3360 460 9453 2751 4304 3460 2750 
1 6 3226 5578 8135 8258 1780 3965 
1 32 3226 778 597 8041 3014 8053 8094 3759 1061 8072 634 8005 342 350 1926 621 3610 2063 6432 2283 1400 5086 3947 2196 167 1152 5893 217 6881 3164 52 6181 
2 12 1061 8250 4344 358 2542 3518 5532 4488 152 1615 4286 3421 
2 15 3150 8730 1285 115 516 8551 8569 2060 8499 5255 8320 1804 8394 8411 358 
2 19 2000 572 1327 9249 9187 551 9084 4182 5027 2547 158 3150 8557 776 344 5566 2173 3897 1152 
2 7 2000 5565 1700 3158 1463 9479 5045 
2 5 3109 8 960 5120 5045 
2 6 3647 2593 3536 1629 1012 3829 
2 13 532 1067 3477 5909 3048 391 287 3743 10363 3272 2968 10406 675 
2 6 6527 1136 871 2195 3232 675 
2 13 3232 2276 6216 896 1876 4218 7044 1679 952 10439 4349 10450 10435 
2 6 2276 3565 1678 684 359 7047 
2 4 359 4020 1371 6589 
2 10 2663 2262 1436 2954 5584 3725 5215 1489 9917 9926 
2 7 9926 86 1087 1643 6589 1554 7047 
2 9 4020 526 10253 4648 3336 381 6155 1757 391 
2 12 9926 1127 6366 1521 3838 7072 2515 9939 3979 1548 1208 9937 
2 9 1554 2637 2375 2816 847 6565 2168 6670 3979 
2 9 2000 3302 420 2676 9688 3836 9801 2413 7072 
2 9 3829 732 6653 143 2774 4553 2184 8852 736 
2 11 732 3679 4672 2922 2687 5136 1778 9074 2975 5033 2187 
1 2 2187 6630 
2 12 10242 10205 181 5766 756 1796 1677 4307 256 4439 8886 2187 
2 11 10435 253 3278 28 6792 4854 1942 2879 888 3187 2050 
2 5 4325 1492 3343 2830 2050 
1 5 888 2315 2111 304 252 
2 2 5331 253 
2 5 2050 2101 2352 1747 6794 
2 5 6794 2626 3200 122 3109 
2 6 5120 6348 4342 3026 6790 1012 
2 10 6792 10401 6536 1096 6907 2917 10423 2610 539 6121 
3 6 1068 205 721 10171 1885 2915 
1 5 8441 4211 1256 4880 6852 
1 7 6852 2700 5340 6863 4521 8181 8125 
1 9 8120 5798 8125 5643 8164 8144 4744 6208 8109 
2 10 8120 8149 6585 4821 2984 618 8173 8156 6602 8167 
1 4 6863 8334 8201 8144 
1 8 8120 8149 8188 8220 8243 8271 6989 4880 
1 7 2700 8425 6265 8478 8498 8516 7103 
1 7 2700 8355 5935 8350 5047 6256 8348 
1 11 5248 6056 333 1093 6886 7820 2962 5308 5961 6274 1046 
1 2 8551 3279 
2 5 9688 2457 5805 2122 1463 
1 2 6181 8234 
1 4 8064 8117 8153 942 
2 7 2418 3504 999 3144 1365 943 2626 
1 7 3617 1687 2597 986 7587 8324 4506 
1 8 3353 5644 7439 6016 6744 499 5720 2441 
1 12 5966 2652 5695 1871 6212 7442 1903 2888 7449 5660 8453 2441 
1 16 8296 8203 1042 8169 993 8067 251 7984 39 7901 7548 2237 7520 7465 7849 7828 
